1 12
WWWWWWWW
W   W  W
W P W  W
W 1 WG W
W      W
W      W
WWWWWWWW
